#########################
#OOGOOOOGOOGOQOOOGOOOGOO#
#O########GO#OG########G#
#G#GOOOOOGOOOGOOOOQOGO#O#
#O#O####OO#####OO####O#O#
#O#OOGO#OQOOGOQOO#OGOO#Q#
#O#G#OO#GO##O##GG#QO#O#O#
#GOO#OG#OO#OOQ#OO#GG#GOO#
#OQO#OQOGOOGOOGOOOOO#OQO#
#OGG#OO#OO#OQO#OO#QO#OGO#
#O#O#GG#GG##O##OO#GG#O#O#
#G#QOOO#OOOOGOOOO#OOOO#O#
#G#O####OO#####OO####O#G#
#O#OGOQOOGOOOGOOOOQOOO#O#
#O########OO#OO########O#
#OOOGOQOGGOOOGOOOGOOGOQO#
#########################