#########################
#OOOOGOOOOGOOOOOOOOOOOOO#
#OOOOOOOOOOOOOOOOOOOOOOO#
#OOOOOGOOOOGOOGOOOOOOOOO#
#OOOOOOOOOOOOOOOOOOOOOOO#
#OOOOOQOOOOOOOOOOOOOOOOO#
#OOOOOOOOOOOOOOOOOOOOOOO#
#OOOGOOOOOOGOOOOOOOOOOOO#
#OOOOOOOOOOOOOGOOOOOOOOO#
#OOOOOOOOOGOOOOOOOOOOOOO#
#OOOOOOOOOOOOOOOOGOOOOOO#
#OOOOOOOOOOOOOOOOOGOOOOO#
#########################